NO ./textures/42_NO.xpm

F 211,1,11

SO ./textures/42_SO.xpm
C 1,1,255
WE ./textures/42_WE.xpm
EA ./textures/42_EA.xpm
111111111111111
100000000000001
100000000000001
100000000000001
100000000000001
101000101111101
101000100000101
101111101111101
100000101000001
100000101111101
100000000000001
10000S000000001
100000000000001
100000000000001
111111111111111
