NO         ./textures/42_NO.xpm
SO ./textures/42_SO.xpm
WE ./textures/42_WE.xpm
EA ./textures/42_E.xpm

F 42, 42, 42
C 142, 142, 142

111111
110101
101001
1100N1
111111
