NO ./textures/42_NO.xpm
SO ./textures/42_SO.xpm
WE ./textures/42_WE.xpm
EA ./textures/42_EA.xpm

F 18,53,25
C 153,204,255

111111111111
100001 10011
100000100001
1111111000111111
10S000000001
111111111111
110000000001
111111111111
