NO ./textures/42_NO.xpm
SO ./textures/42_SO.xpm
WE ./textures/42_WE.xpm
EA ./textures/42_EA.xpm  

F 20,20,20
C 200,-200,200

11111
10001
10001
10001
10001
10001
11S01
10001
10001
10N01
10001
10001
11111
