NO ./textures/42_NO.xpm
SO ./textures/42_SO.xpm
WE ./textures/42_WE.xpm
EA ./textures/42_EA.xpm

C 35,19,73
F 15,6,40

111111111111111111111111111111111111111111
111111111111111111111111111111111111111111
111111111111111111111111111111111111111111
111111111111111111111111111111111111111111
11111111111111111110 E11111111111111111111
111111111111111111111111111111111111111111
111111111111111111111111111111111111111111
111111111111111111111111111111111111111111
111111111111111111111111111111111111111111
