NO ./textures/42_NO.xpm
SO ./textures/42_SO.xpm
WE ./textures/42_WE.xpm
EA ./textures/42_EA.xpm

F 42,42,42
C 142,142,250

111111111111111
100000000000001
100000000000001
100000000000001
100000000000001
101000101111101
101000100000101
101111101111101
100000101000001
100000101111101
100000000000001
100000000000001
1000000E0000001
100000000000001
111111111111111
