NO ./textures/42_NO.xpm
SO ./textures/42_SO.xpm
WE ./textures/42_WE.xpm
EA ./textures/42_EA.xpm

F 18,53,25
C 153,204,255

  1111
111E11
100011
 11001
1 101
1111111
